13 41
*****************************************
*   *       *         *                 *
*** * *** *** ******* * ******* * ***** *
*   *   *     *   *   *   *t  * * *   * *
* * *** ******* * * ***** *** * * * * ***
* *   * *       *   *   *   * * * * *   *
* * *** * *********** * *** * * * * *** *
* * *   *     *     * *   *   * * *   * *
* * *s******* * *** * * ***** * * *** ***
* * * *     * * * *   *     * * * *   * *
* *** *** * * * * ******* *** * *** *** *
*         * *           *     *         *
*****************************************
